//MAP CONVERTED BY dmm2tgm.py THIS HEADER COMMENT PREVENTS RECONVERSION, DO NOT REMOVE
"aa" = (
/turf/template_noop,
/area/template_noop)
"ab" = (
/obj/structure/lattice,
/obj/structure/broken_flooring/singular/directional/north,
/turf/template_noop,
/area/template_noop)
"ac" = (
/obj/structure/lattice,
/turf/template_noop,
/area/template_noop)
"ae" = (
/obj/effect/mapping_helpers/broken_floor,
/turf/open/floor/plating/airless,
/area/template_noop)
"af" = (
/obj/structure/broken_flooring/pile/directional/west,
/turf/template_noop,
/area/template_noop)
"ag" = (
/turf/open/floor/iron/airless,
/area/ruin/space/has_grav)
"ah" = (
/obj/effect/mapping_helpers/broken_floor,
/turf/open/floor/plating/airless,
/area/ruin/space/has_grav)
"ai" = (
/turf/closed/wall,
/area/ruin/space/has_grav)
"aj" = (
/obj/structure/broken_flooring/pile/directional/east,
/turf/template_noop,
/area/template_noop)
"ak" = (
/obj/item/stack/rods,
/obj/effect/mapping_helpers/broken_floor,
/turf/open/floor/plating/airless,
/area/ruin/space/has_grav)
"al" = (
/obj/structure/broken_flooring/singular/directional/east,
/obj/structure/lattice,
/turf/template_noop,
/area/template_noop)
"am" = (
/obj/item/stack/rods,
/turf/open/floor/plating/airless,
/area/ruin/space/has_grav)
"an" = (
/obj/machinery/light/broken/directional/west,
/turf/open/floor/iron/airless,
/area/ruin/space/has_grav)
"ao" = (
/obj/structure/closet/emcloset,
/obj/effect/mapping_helpers/broken_floor,
/turf/open/floor/plating/airless,
/area/ruin/space/has_grav)
"ar" = (
/obj/structure/girder,
/turf/open/floor/plating/airless,
/area/ruin/space/has_grav)
"at" = (
/obj/item/stack/rods,
/turf/open/floor/iron/airless,
/area/ruin/space/has_grav)
"av" = (
/obj/effect/decal/remains/human,
/turf/open/floor/iron/airless,
/area/ruin/space/has_grav)
"aw" = (
/obj/item/stack/sheet/iron,
/turf/open/floor/iron/airless,
/area/ruin/space/has_grav)
"ax" = (
/obj/structure/table,
/obj/item/food/pizza/meat{
	pixel_y = 5
	},
/turf/open/floor/iron/cafeteria/airless,
/area/ruin/space/has_grav)
"az" = (
/obj/structure/broken_flooring/plating/directional/west{
	name = "broken plating"
	},
/obj/structure/lattice,
/turf/template_noop,
/area/ruin/space/has_grav)
"aA" = (
/obj/structure/broken_flooring/pile/directional/north,
/turf/template_noop,
/area/template_noop)
"aB" = (
/obj/item/stack/tile/iron/base,
/obj/effect/mapping_helpers/broken_floor,
/turf/open/floor/plating/airless,
/area/ruin/space/has_grav)
"aC" = (
/obj/structure/lattice,
/obj/item/stack/sheet/iron,
/turf/template_noop,
/area/ruin/space/has_grav)
"aD" = (
/obj/item/stack/tile/iron/base,
/obj/effect/mapping_helpers/broken_floor,
/turf/open/floor/plating/airless,
/area/template_noop)
"aE" = (
/obj/structure/door_assembly/door_assembly_mhatch{
	name = "broken airlock"
	},
/turf/open/floor/plating/airless,
/area/ruin/space/has_grav)
"aF" = (
/obj/machinery/door/airlock/public/glass,
/obj/effect/turf_decal/tile/bar/opposingcorners,
/turf/open/floor/iron/airless,
/area/ruin/space/has_grav)
"aG" = (
/obj/structure/door_assembly/door_assembly_public{
	name = "broken airlock"
	},
/obj/effect/turf_decal/tile/bar/opposingcorners,
/turf/open/floor/iron/airless,
/area/ruin/space/has_grav)
"aH" = (
/turf/open/floor/plating/airless,
/area/ruin/space/has_grav)
"aI" = (
/obj/structure/table,
/obj/machinery/microwave,
/turf/open/floor/iron/cafeteria/airless,
/area/ruin/space/has_grav)
"aJ" = (
/obj/structure/table,
/obj/item/storage/box/drinkingglasses,
/turf/open/floor/iron/cafeteria/airless,
/area/ruin/space/has_grav)
"aK" = (
/obj/structure/closet/secure_closet/freezer/fridge/open,
/obj/machinery/light/broken/directional/north,
/turf/open/floor/iron/cafeteria/airless,
/area/ruin/space/has_grav)
"aL" = (
/turf/open/space/basic,
/area/ruin/space/has_grav)
"aM" = (
/obj/effect/turf_decal/tile/bar/opposingcorners,
/turf/open/floor/iron/airless,
/area/ruin/space/has_grav)
"aN" = (
/obj/item/plate,
/obj/effect/turf_decal/tile/bar/opposingcorners,
/turf/open/floor/iron/airless,
/area/ruin/space/has_grav)
"aO" = (
/obj/item/chair,
/obj/effect/turf_decal/tile/bar/opposingcorners,
/turf/open/floor/iron/airless,
/area/ruin/space/has_grav)
"aP" = (
/obj/machinery/light/broken/directional/north,
/obj/effect/mapping_helpers/broken_floor,
/turf/open/floor/plating/airless,
/area/ruin/space/has_grav)
"aQ" = (
/obj/item/stack/tile/iron/base,
/turf/open/floor/plating/airless,
/area/ruin/space/has_grav)
"aR" = (
/turf/open/floor/iron/cafeteria/airless,
/area/ruin/space/has_grav)
"aS" = (
/obj/structure/table_frame,
/turf/open/floor/iron/cafeteria/airless,
/area/ruin/space/has_grav)
"aU" = (
/obj/structure/table/wood,
/obj/item/shard,
/obj/effect/mapping_helpers/broken_floor,
/turf/open/floor/plating/airless,
/area/ruin/space/has_grav)
"aV" = (
/obj/structure/table/wood,
/obj/item/plate,
/obj/effect/mapping_helpers/broken_floor,
/turf/open/floor/plating/airless,
/area/ruin/space/has_grav)
"aW" = (
/obj/structure/table,
/obj/item/circular_saw/field_medic,
/obj/item/knife/hunting{
	pixel_y = 10
	},
/turf/open/floor/iron/cafeteria/airless,
/area/ruin/space/has_grav)
"aX" = (
/obj/item/chair/stool/bar,
/obj/effect/turf_decal/tile/bar/opposingcorners,
/turf/open/floor/iron/airless,
/area/ruin/space/has_grav)
"aZ" = (
/turf/open/space/basic,
/area/template_noop)
"ba" = (
/obj/effect/mob_spawn/corpse/human/cook,
/turf/open/floor/iron/cafeteria/airless,
/area/ruin/space/has_grav)
"bb" = (
/obj/item/stack/sheet/iron,
/obj/structure/lattice,
/turf/template_noop,
/area/ruin/space/has_grav)
"bc" = (
/obj/structure/table,
/obj/item/shard,
/turf/open/floor/iron/cafeteria/airless,
/area/ruin/space/has_grav)
"bd" = (
/obj/structure/chair/stool/bar/directional/west,
/obj/effect/turf_decal/tile/bar/opposingcorners,
/turf/open/floor/iron/airless,
/area/ruin/space/has_grav)
"bg" = (
/obj/item/stack/sheet/iron,
/obj/effect/mapping_helpers/broken_floor,
/turf/open/floor/plating/airless,
/area/ruin/space/has_grav)
"bi" = (
/obj/item/stack/sheet/iron,
/obj/item/clothing/head/utility/chefhat,
/obj/effect/mapping_helpers/broken_floor,
/turf/open/floor/plating/airless,
/area/ruin/space/has_grav)
"bj" = (
/obj/item/plate,
/obj/effect/decal/remains/human,
/turf/open/floor/iron/cafeteria/airless,
/area/ruin/space/has_grav)
"bk" = (
/obj/structure/table_frame/wood,
/obj/effect/mapping_helpers/broken_floor,
/turf/open/floor/plating/airless,
/area/ruin/space/has_grav)
"bl" = (
/obj/structure/girder,
/obj/effect/mapping_helpers/broken_floor,
/turf/open/floor/plating/airless,
/area/ruin/space/has_grav)
"bm" = (
/obj/structure/lattice,
/obj/item/shard,
/turf/template_noop,
/area/ruin/space/has_grav)
"bo" = (
/obj/item/stack/rods,
/turf/template_noop,
/area/template_noop)
"bp" = (
/obj/item/stack/sheet/iron,
/obj/structure/girder,
/obj/effect/mapping_helpers/broken_floor,
/turf/open/floor/plating/airless,
/area/ruin/space/has_grav)
"br" = (
/obj/structure/girder,
/obj/item/stack/sheet/iron,
/obj/effect/mapping_helpers/broken_floor,
/turf/open/floor/plating/airless,
/area/ruin/space/has_grav)
"bt" = (
/obj/structure/broken_flooring/side/directional/north,
/obj/structure/lattice,
/turf/template_noop,
/area/ruin/space/has_grav)
"bu" = (
/turf/template_noop,
/area/ruin/space/has_grav)
"bv" = (
/obj/structure/broken_flooring/pile/directional/south,
/turf/template_noop,
/area/template_noop)
"bw" = (
/obj/structure/lattice,
/obj/structure/broken_flooring/plating/directional/north{
	name = "broken plating"
	},
/turf/template_noop,
/area/ruin/space/has_grav)
"bx" = (
/obj/structure/broken_flooring/plating/directional/east{
	name = "broken plating"
	},
/obj/structure/lattice,
/turf/template_noop,
/area/ruin/space/has_grav)
"by" = (
/obj/structure/broken_flooring/pile/directional/east,
/turf/open/floor/iron/airless,
/area/ruin/space/has_grav)
"bz" = (
/obj/structure/lattice,
/obj/structure/broken_flooring/plating/directional/east{
	name = "broken plating"
	},
/turf/template_noop,
/area/ruin/space/has_grav)
"bA" = (
/obj/structure/broken_flooring/singular/directional/south,
/turf/template_noop,
/area/template_noop)
"bC" = (
/obj/structure/lattice,
/obj/structure/broken_flooring/corner/directional/north,
/turf/template_noop,
/area/ruin/space/has_grav)
"bD" = (
/obj/structure/broken_flooring/singular/directional/east,
/turf/open/floor/iron/airless,
/area/ruin/space/has_grav)
"bE" = (
/obj/item/chair,
/obj/effect/mapping_helpers/broken_floor,
/turf/open/floor/plating/airless,
/area/template_noop)
"bF" = (
/obj/structure/lattice,
/turf/template_noop,
/area/ruin/space/has_grav)
"bG" = (
/obj/item/stack/sheet/iron,
/obj/effect/mapping_helpers/broken_floor,
/obj/effect/turf_decal/tile/bar/opposingcorners,
/turf/open/floor/plating/airless,
/area/template_noop)
"bH" = (
/obj/structure/broken_flooring/plating/directional/south{
	name = "broken plating"
	},
/obj/structure/lattice,
/turf/template_noop,
/area/ruin/space/has_grav)
"bI" = (
/obj/structure/lattice,
/obj/structure/broken_flooring/plating/directional/west{
	name = "broken plating"
	},
/turf/template_noop,
/area/ruin/space/has_grav)
"JE" = (
/obj/structure/table,
/obj/item/food/pizzaslice/mothic_firecracker,
/obj/item/food/pizzaslice/mothic_firecracker{
	pixel_x = 10;
	pixel_y = 5
	},
/obj/item/food/pizzaslice/mothic_firecracker{
	pixel_y = 15
	},
/turf/open/floor/iron/cafeteria/airless,
/area/ruin/space/has_grav)
"Lq" = (
/obj/effect/mob_spawn/corpse/human/pirate/melee,
/turf/open/floor/iron/airless,
/area/ruin/space/has_grav)

(1,1,1) = {"
aa
aa
aa
aa
aa
aa
aa
ac
aa
aa
aa
aa
aa
aa
aa
aa
aa
aa
aa
aa
aa
"}
(2,1,1) = {"
aZ
aa
aa
aa
aa
aa
bA
aa
ac
aZ
aZ
aZ
aZ
aZ
aZ
aZ
aZ
aZ
aa
aa
aa
"}
(3,1,1) = {"
aZ
aa
aa
aa
aa
aZ
aa
bF
bC
aa
aj
aa
aZ
aa
aa
aa
aa
aa
aZ
aZ
aa
"}
(4,1,1) = {"
aZ
aa
aa
aa
aa
bF
ah
aw
ag
bu
bu
aa
ac
ac
aa
af
aZ
aZ
aZ
aZ
aa
"}
(5,1,1) = {"
aZ
aa
aa
aa
bu
bF
bl
ag
ag
ah
bH
bu
bF
bF
bF
bu
bu
aL
aL
aZ
aa
"}
(6,1,1) = {"
aZ
aa
aZ
aZ
bF
bw
ah
at
bD
ah
ah
ah
ah
bF
bF
bF
bu
bu
aL
aZ
aa
"}
(7,1,1) = {"
aZ
aa
aZ
aa
bu
ah
ai
aw
ag
ai
ai
ai
bl
ah
bg
ah
aL
aL
aL
aa
aa
"}
(8,1,1) = {"
aZ
aa
aZ
bF
bF
am
ai
ag
ag
aE
aH
aQ
aH
bl
ah
aB
ah
bF
aL
ac
aa
"}
(9,1,1) = {"
aZ
aa
aZ
bF
bF
ah
ai
av
Lq
ai
ai
ai
ai
ai
ai
bl
bp
ah
ac
aZ
aa
"}
(10,1,1) = {"
aZ
aa
aa
bF
bF
ah
bl
ag
aw
ai
aI
aR
ax
aW
aJ
ah
ah
br
aa
aZ
aZ
"}
(11,1,1) = {"
aZ
aa
bu
bw
bg
ai
ai
ag
ag
ai
aR
aR
aR
aR
aR
ah
aB
bl
ab
aZ
aZ
"}
(12,1,1) = {"
aZ
ab
bF
ag
ag
an
ag
ag
ag
ai
aK
bi
aR
ba
bj
bg
ah
bl
ac
aZ
aZ
"}
(13,1,1) = {"
aZ
bF
bt
ag
by
ag
ag
ag
ag
ai
ai
aS
JE
bc
aR
aS
ai
ai
ac
aZ
aZ
"}
(14,1,1) = {"
aZ
bu
bu
bl
ai
ai
ai
ag
ag
ai
aM
aM
aX
bd
aM
aX
aM
ai
ac
aZ
aZ
"}
(15,1,1) = {"
aZ
aa
bF
ah
ah
ao
ai
ag
ag
aF
aN
bI
bF
ah
ah
bF
bg
bl
aa
aZ
aZ
"}
(16,1,1) = {"
aZ
aa
bF
bx
ak
ah
ai
ag
ag
aG
aO
aU
aD
ah
bk
bE
az
bF
aa
aZ
aa
"}
(17,1,1) = {"
aZ
aa
bu
bb
ah
ah
bl
ag
ag
ai
aM
ah
ah
ah
bF
ah
bF
aa
bo
aZ
aa
"}
(18,1,1) = {"
aZ
aa
aa
bu
bz
ah
ai
ag
ag
ai
aM
ah
bF
ah
ae
bm
aa
aA
aa
aa
aa
"}
(19,1,1) = {"
aZ
aa
aa
bu
bF
ah
ai
ag
ag
ai
aP
aV
bG
ah
bF
ac
aa
aa
aa
aa
aa
"}
(20,1,1) = {"
aZ
aa
aa
bv
bu
bg
ar
ag
ag
ai
ah
ah
ah
aC
ac
ac
aa
aa
aa
aZ
aa
"}
(21,1,1) = {"
aZ
aa
aa
aa
bu
bF
ah
ag
ag
ai
ai
ai
bl
ac
aa
bo
aa
aa
aa
aa
aa
"}
(22,1,1) = {"
aZ
aa
aZ
aa
aa
bu
bu
aw
at
ai
aL
aL
aL
aZ
aZ
aZ
aZ
aZ
aa
aa
aa
"}
(23,1,1) = {"
aZ
aa
aa
aa
aa
aa
aa
al
bF
ai
ac
ac
aa
aa
aa
aa
aa
aa
aa
aa
aa
"}
(24,1,1) = {"
aZ
aa
aa
aa
aa
aa
aa
aa
ac
aa
aa
aa
aa
aa
aa
aa
aa
aa
aa
aa
aa
"}
(25,1,1) = {"
aZ
aZ
aZ
aZ
aZ
aZ
aZ
aa
aa
aa
aa
aa
aa
aa
aa
aa
aa
aa
aa
aa
aa
"}
